"a" = (/turf/space,/area/space)
"b" = (/turf/simulated/wall,/area/constructionsite)
"c" = (/turf/simulated/floor/tiled,/area/constructionsite)
"d" = (/obj/machinery/light{dir = 1},/turf/simulated/floor/tiled,/area/constructionsite)
"e" = (/turf/simulated/wall/r_wall,/area/constructionsite)
"f" = (/obj/machinery/light{icon_state = "tube1"; dir = 4},/turf/simulated/floor/tiled,/area/constructionsite)
"g" = (/obj/effect/landmark/start,/turf/simulated/floor/tiled,/area/constructionsite)
"h" = (/obj/structure/bed/chair/armchair/blue,/obj/effect/landmark/corpse/guns_test_four,/turf/simulated/floor/reinforced,/area/constructionsite)
"i" = (/obj/structure/bed/chair/armchair/blue,/obj/effect/landmark/corpse/guns_test_three,/turf/simulated/floor/reinforced,/area/constructionsite)
"j" = (/obj/machinery/light/spot{icon_state = "tube_map"; dir = 8},/turf/simulated/floor/reinforced,/area/constructionsite)
"k" = (/obj/machinery/light,/turf/simulated/floor/tiled,/area/constructionsite)
"l" = (/obj/effect/landmark{name = "tdome1"},/turf/simulated/floor/tiled,/area/constructionsite)
"m" = (/obj/machinery/atmospherics/pipe/simple/visible{icon_state = "intact"; dir = 5},/turf/simulated/floor/tiled,/area/constructionsite)
"n" = (/obj/machinery/atmospherics/portables_connector{icon_state = "map_connector"; dir = 8},/obj/machinery/portable_atmospherics/canister/air,/turf/simulated/floor/tiled,/area/constructionsite)
"o" = (/obj/machinery/atmospherics/pipe/simple/visible{icon_state = "intact"; dir = 4},/turf/simulated/floor/tiled,/area/constructionsite)
"p" = (/obj/machinery/atmospherics/pipe/simple/visible{icon_state = "intact"; dir = 6},/turf/simulated/floor/tiled,/area/constructionsite)
"q" = (/obj/machinery/atmospherics/portables_connector{icon_state = "map_connector"; dir = 8},/obj/machinery/portable_atmospherics/canister/empty,/turf/simulated/floor/tiled,/area/constructionsite)
"r" = (/obj/machinery/atmospherics/unary/vent_scrubber/on{icon_state = "map_scrubber_on"; dir = 1},/turf/simulated/floor/tiled,/area/constructionsite)
"s" = (/obj/machinery/atmospherics/unary/vent_pump/on,/turf/simulated/floor/tiled,/area/constructionsite)
"t" = (/turf/simulated/floor/reinforced,/area/constructionsite)
"u" = (/obj/item/weapon/paper/liners_example_armor,/turf/simulated/floor/reinforced,/area/constructionsite)
"v" = (/obj/structure/bed/chair/armchair/blue,/obj/effect/landmark/corpse/guns_test_two,/turf/simulated/floor/reinforced,/area/constructionsite)
"w" = (/obj/effect/floor_decal/industrial/hatch/yellow,/turf/simulated/floor/tiled,/area/constructionsite)
"x" = (/obj/item/weapon/paper/liners_example_guns,/turf/simulated/floor/reinforced,/area/constructionsite)
"y" = (/turf/simulated/wall/iron,/area/shuttle/escape)
"z" = (/obj/effect/wingrille_spawn/reinforced,/turf/simulated/floor/plating,/area/shuttle/escape)
"A" = (/obj/machinery/computer/shuttle_control{shuttle_tag = "Example"},/turf/simulated/floor/plating,/area/shuttle/escape)
"B" = (/obj/structure/bed/chair{dir = 1},/obj/machinery/embedded_controller/radio/simple_docking_controller{id_tag = "example_shuttle_starboard"; pixel_x = 28},/obj/machinery/embedded_controller/radio/simple_docking_controller{id_tag = "example_shuttle_port"; pixel_x = -28},/obj/effect/shuttle_landmark/lower_level,/turf/simulated/floor/plating,/area/shuttle/escape)
"C" = (/obj/machinery/light,/turf/simulated/floor/plating,/area/shuttle/escape)
"D" = (/obj/machinery/door/airlock/external/bolted{frequency = 1379; id_tag = "example_shuttle_port_hatch"},/turf/simulated/floor/plating,/area/shuttle/escape)
"E" = (/obj/machinery/door/airlock/external/bolted{frequency = 1379; id_tag = "example_shuttle_starboard_hatch"},/turf/simulated/floor/plating,/area/shuttle/escape)
"F" = (/obj/machinery/embedded_controller/radio/simple_docking_controller{id_tag = "lower_level_dock"; pixel_x = -8; pixel_y = -25},/turf/simulated/floor,/area/constructionsite)
"G" = (/obj/machinery/door/airlock/external/bolted{frequency = 1379; id_tag = "lower_level_dock_hatch"},/turf/simulated/floor,/area/constructionsite)
"H" = (/obj/item/weapon/gun/projectile/pistol/magnum_pistol,/obj/item/weapon/gun/projectile/pistol/magnum_pistol,/obj/item/weapon/gun/projectile/pistol/magnum_pistol,/obj/item/weapon/gun/projectile/pistol/magnum_pistol,/turf/simulated/floor/tiled/skrell/red,/area/constructionsite)
"I" = (/obj/effect/landmark/test/safe_turf,/turf/simulated/floor/tiled,/area/constructionsite)
"J" = (/obj/effect/landmark/test/space_turf,/turf/space,/area/space)
"K" = (/obj/machinery/light/spot{icon_state = "tube_map"; dir = 4},/turf/simulated/floor/reinforced,/area/constructionsite)
"L" = (/obj/item/weapon/gun/projectile/revolver/holdout,/obj/item/weapon/gun/projectile/revolver/holdout,/obj/item/weapon/gun/projectile/revolver/holdout,/obj/item/weapon/gun/projectile/revolver/holdout,/obj/item/weapon/gun/projectile/revolver/holdout,/turf/simulated/floor/tiled/skrell/orange,/area/constructionsite)
"M" = (/obj/structure/bed/chair/armchair/blue,/obj/effect/landmark/corpse/guns_test_one,/turf/simulated/floor/reinforced,/area/constructionsite)
"N" = (/obj/machinery/light/spot,/turf/simulated/floor/tiled,/area/constructionsite)
"O" = (/obj/item/weapon/gun/projectile/pistol/sec/lethal,/obj/item/weapon/gun/projectile/pistol/sec/lethal,/obj/item/weapon/gun/projectile/pistol/sec/lethal,/obj/item/weapon/gun/projectile/pistol/sec/lethal,/obj/item/weapon/gun/projectile/pistol/sec/lethal,/obj/item/weapon/gun/projectile/pistol/sec/lethal,/turf/simulated/floor/tiled/skrell/green,/area/constructionsite)
"P" = (/obj/effect/landmark{name = "JoinLate"},/obj/machinery/light/spot{icon_state = "tube_map"; dir = 4},/turf/simulated/floor/reinforced,/area/constructionsite)
"Q" = (/obj/structure/bed/chair/armchair/blue,/obj/effect/landmark/corpse,/turf/simulated/floor/reinforced,/area/constructionsite)
"R" = (/obj/item/weapon/gun/projectile/pistol/sec,/obj/item/weapon/gun/projectile/pistol/sec,/obj/item/weapon/gun/projectile/pistol/sec,/obj/item/weapon/gun/projectile/pistol/sec,/obj/item/weapon/gun/projectile/pistol/sec,/turf/simulated/floor/tiled/skrell,/area/constructionsite)
"S" = (/obj/effect/landmark{name = "JoinLate"},/turf/simulated/floor/reinforced,/area/constructionsite)
"T" = (/obj/structure/cable{d2 = 2; icon_state = "0-2"; pixel_y = 0},/obj/machinery/power/apc{dir = 8; name = "west bump"; pixel_x = -24},/turf/simulated/floor/reinforced,/area/constructionsite)
"U" = (/obj/structure/cable{d1 = 1; d2 = 2; icon_state = "1-2"; pixel_y = 0},/turf/simulated/floor/reinforced,/area/constructionsite)
"V" = (/obj/structure/cable,/obj/machinery/power/debug_items/infinite_generator,/turf/simulated/floor/reinforced,/area/constructionsite)

(1,1,1) = {"
aaaaaaaaaaaaaaaaaaaaaaaaaaaaaaaaaaaaaaaaaaaaaaaa
aaaaaaaaaaaaaaaaaaaaaaaaaaaaaaaaaaaaaaaaaaaaaaaa
aaaaaaaaaaaaaaaaaaaaaaaaaaaaaaaaaaaaaaaaaaaaaaaa
aaaaaaaaaaaaaaaaaaaaaaaaaaaaaaaaaaaaaaaaaaaaaaaa
aaaaaaaaaaaaaaaaaaaaaaaaaaaaaaaaaaaaaaaaaaaaaaaa
aaaaaaaaaaaaaaaaaaaaaaaaaaaaaaaaaaaaaaaaaaaaaaaa
aaaaaaaaaaaaaaaaaaaaaaaaaaaaaaaaaaaaaaaaaaaaaaaa
aaaaaaaaaaaaaaaaaaaaaaaaaaaaaaaaaaaaaaaaaaaaaaaa
aaaaaaaaaaaaaaaaaaaaaaaaaaaaaaaaaaaaaaaaaaaaaaaa
aaaaaaaaaaaaaaaaabbbbbbbbbbbbbbbaaaaaaaaaaaaaaaa
aaaaaaaaaaaaaaaaaeeeeeeecccdcccbaaaaaaaaaaaaaaaa
aaaaaaaaaaaaaaaaaeeeeeeebwcccccbaaaaaaaaaaaaaaaa
aaaaaaaaaaaaaaaaaehivMQewwcccccbaaaaaaaaaaaaaaaa
aaaaaaaaaaaaaaaaaetttttewwccccfbaaaaaaaaaaaaaaaa
aaaaaaaaaaaaaaaaaejtttKecNccsccbaaaaaaaaaaaaaaaa
aaaaaaaaaaaayyyaaettttHeccclmonbaaaaaaaaaaaaaaaa
aaaaaaaaaaaazAzaaettttLegccccccbaaaaaaaaaaaaaaaa
aaaaaaaaaaaazBzbbeutttOecccIpoqbaaaaaaaaaaaaaaaa
aaaaaaaaaaaaDCEGFextttReccccrccbaaaaaaaaaaaaaaaa
aaaaaaaaaaaayyybbejtSSPeccccccfbaaaaaaaaaaaaaaaa
aaaaaaaaaaaaaaaaaeTtSSSecNcccccbaaaaaaaaaaaaaaaa
aaaaaaaaaaaaaaaaaeUtSSSecccccccbaaaaaaaaaaaaaaaa
aaaaaaaaaaaaaaaaaeVtttteccckcccbaaaaaaaaaaaaaaaa
aaaaaaaaaaaaaaaaaeeeeeeebbbbbbbbaaaaaaaaaaaaaaaa
aaaaaaaaaaaaaaaaaaaaaaaaaaaaaaaaaaaaaaaaaaaaaaaa
aaaaaaaaaaaaaaaaaaaaaaaaaaaaaaaaaaaaaaaaaaaaaaaa
aaaaaaaaaaaaaaaaaaaaaaJaaaaaaaaaaaaaaaaaaaaaaaaa
aaaaaaaaaaaaaaaaaaaaaaaaaaaaaaaaaaaaaaaaaaaaaaaa
aaaaaaaaaaaaaaaaaaaaaaaaaaaaaaaaaaaaaaaaaaaaaaaa
aaaaaaaaaaaaaaaaaaaaaaaaaaaaaaaaaaaaaaaaaaaaaaaa
aaaaaaaaaaaaaaaaaaaaaaaaaaaaaaaaaaaaaaaaaaaaaaaa
aaaaaaaaaaaaaaaaaaaaaaaaaaaaaaaaaaaaaaaaaaaaaaaa
"}
